111111111111111111111
1P000000C000000000001
10000M000000000000101
101111111111111111101
101CCCCCCCCCCCCCCC001
1E1111111111111111111
111111111111111111111