1111111111111111111111
11P11111111CC111111E11
1001111111000111111001
1C100000000M00000001C1
1001111111000111111001
110CCCCCCCCCCCCCCCC011
1111111111111111111111
