1111111111111111111111111111111
10000P00001M00000010000001E0001
1C00110C0011C101C1C001100111101
1000001111111101111111000000001
100C000000000000000000000C00001
1111111111111111111111111111111