111111111
11P000E11
1000M0001
11C101C11
111111111
