111111111
1P00000E1

100C00011
111111111
